1111111111111111111111111
1000200220100200200200001
1011111111121111111111101
1212201020101020022000101
1212101110101011111110121
1015102210101012002212101
1011110110121012111210101
1000010220022010101012101
1111011111111112121010121
1220020002200010101020101
1211111111110112101111101
1010020220010120100220121
1210111111010101111101101
1210102001210120220120101
1010101101011111101110121
1010101101002200101020101
1010001101111112101011101
1011111100220010101010201
1002200111110110121011111
1011110220010122101002201
1210011110110121101111101
1000012002000100220000001
1000210011111111111100401
1300220120002200200000001
1111111111111111111111111