1111111111111111111111111
1000001000001000000000081
1011101011101011101011111
1010001000100010001000001
1010111110111110111111101
1010100000000010000000101
1010101101111011111110101
1000001909101000000010101
1111111909101111111010101
1000001111100000001010101
1011100000111011101010101
1010111110100000101000101
1010000010101010101111101
1011111010101c10100000101
1000001010101110111110101
1111101010100000000010101
1000101010111111111010101
1010101010000000001010001
1010101011111111101011101
1010000010000000100000101
1011111110111110111110101
1400000010100000000010101
11111110101a00a1111010101
15000000001aaaa1000010001
1111111111111111111111111